55555555555555555555555555555555555555555555555555555555555555555555555555555555555555555555555555555555555555555555555555555555
55555555555555555555552222222222222222222222222222222222222222222222222222222222222222222222222222222222222555555555555555555555
55555555555555555555531111111111111111111111111111111111111111441111111111111111111111111111111111111111111355555555555555555555
55555555555555555555311111111111111111111111111111111111111111441111111111111111111111111111111111111111111135555555555555555555
55555555555555555553111111111111111111111111111111111111111111441111111111111111111111111111111111111111111113555555555555555555
55555555555555555531111111111111111111111111111111111111111111441111111111111111111111111111111111111111111111355555555555555555
55555555555555555311111111111111111111111111111111111111111111441111111111111111111111111111111111111111111111135555555555555555
55555555555555553111111111111111111111111111111111111111111111441111111111111111111111111111111111111111111111135555555555555555
55555555555555553111111111111111111111111111111111111111111111441111111111111111111111111111111111111111111111135555555555555555
55555555555555553111111111111111111111111111111111111111111111441111111111111111111111111111111111111111111111135555555555555555
55555555555555553111111111111111111111111111111111111111111111441111111111111111111111111111111111111111111111135555555555555555
55555555555555553111111111111111111222222222222222222222222222222222222222222222222222211111111111111111111111355555555555555555
55555555555555531111111111111111113555555555555555555555555555555555555555555555555555531111111111111111111113555555555555555555
55555555555555311111111111111111135555555555555555555555555555555555555555555555555555553111111111111111111135555555555555555555
55555555555553111111111111111111355555555555555555555555555555555555555555555555555555531111111111111111111355555555555555555555
55555555555531111111111111111113555555555555555555555555555555555555555555555555555555311111111111111111113555555555555555555555
55555555555311111111111111111135555555555555555555555555555555555555555555555555555553111111111111111111135555555555555555555555
55555555553111111111111111111355555555555555555555555555555555555555555555555555555531111111111111111111355555555555555555555555
55555555531111111111111111113555555555555555555555555555555555555555555555555555555311111111111111111113555555555555555555555555
55555555311111111111111111135555555555555555555555555555555555555555555555555555553111111111111111111135555555555555555555555555
55555553111111111111111111355555555555555555555555555555555555555555555555555555531111111111111111111355555555555555555555555555
55555531111111111111111113555555555555555555555555555555555555555555555555555555311111111111111111111355555555555555555555555555
55555531111111111111111135555555555555555555555555555555555555555555555555555555311111111111111111111355555555555555555555555555
55555531111111111111111355555555555555555555555555555555555555555555555555555555311111111111111111111355555555555555555555555555
55555531111111111111111355555555555555555555555555555555555555555555555555555555311111111111111111111355555555555555555555555555
55555531111111111111111355555555555555555555555555555555555555555555555555555555311111111111111111111135555555555555555555555555
55555531111111111111111135555555555555555555555555555555555555555555555555555555311111111111111111111135555555555555555555555555
55555531111111111111111113555555555555555555555555555555555555555555555555555555311111111111111111111113555555555555555555555555
55555531111111111111111111355555555555555555555555555555555555555555555555555555311111111111111111111111355555555555555555555555
55555553111111111111111111135555555555555555555555555555555555555555555555555555531111111111111111111111135555555555555555555555
55555555311111111111111111113555555555555555555555555555555555555555555555555555553111111111111111111111113555555555555555555555
55555555531111111111111111111355555555555555555555555555555555555555555555555555555311111111111111111111111355555555555555555555
55555555553111111111111111111135555555555555555555555555555555555555555555555555555531111111111111111111111135555555555555555555
55555555555311111111111111111113555555555555555555555555555555555555555555555555555553111111111111111111111113555555555555555555
55555555555531111111111111111111355555555555555555555555555555555555555555555555555555311111111111111111111111355555555555555555
55555555555553111111111111111111135555555555555555555555555555555555555555555555555555531111111111111111111111135555555555555555
55555555555555311111111111111111113555555555555555555555555555555555555555555555555555553111111111111111111111113555555555555555
55555555555555531111111111111111113555555555555555555555555555555555555555555555555555555311111111111111111111111355555555555555
55555555555555553111111111111111113555555555555555555555555555555555555555555555555555555531111111111111111111111135555555555555
55555555555555555311111111111111113555555555555555555555555555555555555555555555555555555553111111111111111111111113555555555555
55555555555555555531111111111111111355555555555555555555555555555555555555555555555555555555311111111111111111111111355555555555
55555555555555555553111111111111111135555555555555555555555555555555555555555555555555555555531111111111111111111111355555555555
55555555555555555555311111111111111113555555555555555555555555555555555555555555555555555555531111111111111111111111355555555555
55555555555555555555531111111111111111355555555555555555555555555555555555555555555555555555531111111111111111111111355555555555
55555555555555555555553111111111111111135555555555555555555555555555555555555555555555555555531111111111111111111111355555555555
55555555555555555555555311111111111111113555555555555555555555555555555555555555555555555555311111111111111111111111355555555555
55555555555555555555555531111111111111111355555555555555555555555555555555555555555555555553111111111111111111111111355555555555
55555555555555555555555553111111111111111135555555555555555555555555555555555555555555555531111111111111111111111111355555555555
55555555555555555555555553111111111111111113555555555555555555555555555555555555555555555311111111111111111111111113555555555555
55555555555555555555555553111111111111111111355555555555555555555555555555555555555555553111111111111111111111111135555555555555
55555555555555555555555553111111111111111111122222222222222222222222222222222222222222221111111111111111111111111355555555555555
55555555555555555555555553111111111111111111111111111111111111111111111111111111111111111111111111111111111111113555555555555555
55555555555555555555555555311111111111111111111111111111111111111111111111111111111111111111111111111111111111135555555555555555
55555555555555555555555555531111111111111111111111111111111111111111111111111111111111111111111111111111111111355555555555555555
55555555555555555555555555553111111111111111111111111111111111111111111111111111111111111111111111111111111113555555555555555555
55555555555555555555555555555311111111111111111111111111111111111111111111111111111111111111111111111111111135555555555555555555
55555555555555555555555555555531111111111111111111111111111111111111111111111111111111111111111111111111111355555555555555555555
55555555555555555555555555555553111111111111111111111111111111111111111111111111111111111111111111111111113555555555555555555555
55555555555555555555555555555555311111111111111111111111111111111111111111111111111111111111111111111111135555555555555555555555
55555555555555555555555555555555531111111111111111111111111111111111111111111111111111111111111111111111355555555555555555555555
55555555555555555555555555555555553111111111111111111111111111111111111111111111111111111111111111111113555555555555555555555555
55555555555555555555555555555555555311111111111111111111111111111111111111111111111111111111111111111135555555555555555555555555
55555555555555555555555555555555555531111111111111111111111111111111111111111111111111111111111111111355555555555555555555555555
55555555555555555555555555555555555552222222222222222222222222222222222222222222222222222222222222222555555555555555555555555555
55555555555555555555555555555555555555555555555555555555555555555555555555555555555555555555555555555555555555555555555555555555
55555555555555555555555555555555555555555555555555555555555555555555555555555555555555555555555555555555555555555555555555555555
55555555555555555555555555555555555555555555555555555555555555555555555555555555555555555555555555555555555555555555555555555555
55555555555555555555555555555555555555555555555555555555555555555555555555555555555555555555555555555555555555555555555555555555
55555555555555555555555555555555555555555555555555555555555555555555555555555555555555555555555555555555555555555555555555555555
55555555555555555555555555555555555555555555555555555555555555555555555555555555555555555555555555555555555555555555555555555555
55555555555555555555555555555555555555555555555555555555555555555555555555555555555555555555555555555555555555555555555555555555
55555555555555555555555555555555555555555555555555555555555555555555555555555555555555555555555555555555555555555555555555555555



